NO texture/mine/wall_detailed.xpm


SO texture/mine/wall_detailed.xpm


WE                               texture/mine/wall_detailed.xpm
EA texture/mine/wall_detailed.xpm

F    texture/mine/floor_detailed.xpm
C    texture/mine/ceiling_detailed.xpm

D      texture/mine/door_closed.xpm
P       ./texture/Player/shotgun 
         11111111111111111111111111
        1000000000110000000000001
        1011000001110000000000001
        10010000000D0000000000001
11111111101100000111000000000001
10000000001100000111011111D111111111111111
11110111111111011100000010001
111011111111100D0010100100001
11000000110101011100000010001
10000000000000001100000010001
10000000000000001101010010001
110000011101S101111101111000111
11110111  110101 101111010001
 111111 1111111 111111111111
 




 