NO ./texture/Wolfenstein3DWalls/03_Wolfenstein3DWalls1735817064.xpm


SO ./texture/Wolfenstein3DWalls/03_Wolfenstein3DWalls1735817064.xpm


WE                               ./texture/Wolfenstein3DWalls/03_Wolfenstein3DWalls1735817064.xpm
EA ./texture/Wolfenstein3DWalls/03_Wolfenstein3DWalls1735817064.xpm

F    ./texture/Wolfenstein3DWalls/24_Wolfenstein3DWalls1735817069.xpm
C    ./texture/Wolfenstein3DWalls/01_Wolfenstein3DWalls1735817064.xpm
D       ./texture/Wolfenstein3DWalls/33_Wolfenstein3DWalls1735817071.xpm
P       ./texture/Player/shotgun

        11111111111111111111111111
        1000000000110000000000001
        1011000001110000000000001
        10010000000D000000W000001
11111111101100000111000000000001
10000000001100000111011111D111111
11110111111111011100000010001
11101111111110111010100100001
11000000110101011100000010001
10000000000000001100000010001
10000000000000001101010010001
1100000111010101111101111000111
11110111 1110101 101111010001
11111111 1111111 111111111111