NO ./texture/Wolfenstein3DWalls/02_Wolfenstein3DWalls1735817064.xpm

WE ./texture/Wolfenstein3DWalls/10_Wolfenstein3DWalls1735817066.xpm

C 198,227,50

SO ./texture/Wolfenstein3DWalls/06_Wolfenstein3DWalls1735817065.xpm

EA ./texture/Wolfenstein3DWalls/11_Wolfenstein3DWalls1735817066.xpm

F 0,113,39

1111111111111111111111111111
100000E000110000000000000001
10110000011100000001111011111
11111111110000000000000000011111
10110000011100000000000111111111
10000000001100000111111110111111
111111111111110111000000100011111111
11110111111111011101010010001
11000000110101011100000010001
11111111000000001100000010001
10000000000000001100011111111
11110000110101000000000011111
11111111110101000000000000001
10000000001100000100000010001
10000000000000000000000001001
10000000111100010000000001001
100000001  100110101110000001
10000000111110000001 10111111
11111111111111111111 1111111
