NO ./texture/Wolfenstein3DWalls/08_Wolfenstein3DWalls1735817065.xpm


SO ./texture/Wolfenstein3DWalls/08_Wolfenstein3DWalls1735817065.xpm


WE                               ./texture/Wolfenstein3DWalls/08_Wolfenstein3DWalls1735817065.xpm
EA ./texture/Wolfenstein3DWalls/08_Wolfenstein3DWalls1735817065.xpm
F 220,100,0
C 225,30,0

111111111111111
100100000001001
100100011101001
100000000000001
111100000001111
100001000N00001
100001000001001
100001000000001
100001000000001
111111111111111
